.-.-.---.-...-...---
.-.-.-...-...-...-.-
.---.---.-...-...-.-
.-.-.-...-...-...-.-
.-.-.---.---.---.---
....................
.-.-.---.---.-...--.
.-.-.-.-.-.-.-...-.-
.-.-.-.-.---.-...-.-
.---.-.-.--..-...-.-
.-.-.---.-.-.---.--.
....................
....................
.1................X.
####################
